ID accountsummary            | Name: Report Suite Totals 
ID activity                  | Name: Activity 
ID browser                   | Name: Browser 
ID browserheight             | Name: Browser Height 
ID browsertype               | Name: Browser Type 
ID browserwidth              | Name: Browser Width 
ID category                  | Name: Category 
ID connectiontype            | Name: Connection Type 
ID cookiesenabled            | Name: Cookies Enabled 
ID customerloyalty           | Name: Customer Loyalty 
ID domain                    | Name: Domain 
ID entrypage                 | Name: Entry Page 
ID entrypageoriginal         | Name: Original Entry Page 
ID evar1                     | Name: Screen Name 
ID evar10                    | Name: Subsection Level 3 
ID evar100                   | Name: Marketing Cloud Visitor ID 
ID evar13                    | Name: Product Type 
ID evar15                    | Name: Add-to-Cart Location 
ID evar16                    | Name: Payment Method 
ID evar18                    | Name: Order ID 
ID evar19                    | Name: Transaction Status 
ID evar2                     | Name: eVar 2 
ID evar22                    | Name: Internal Campaign Tracking Code 
ID evar23                    | Name: Customer ID 
ID evar24                    | Name: Logged In/Not Logged In 
ID evar26                    | Name: Logout Location 
ID evar3                     | Name: eVar 3 
ID evar34                    | Name: Add-to-Wishlist Location 
ID evar35                    | Name: Product Stock Status 
ID evar36                    | Name: Search Type 
ID evar37                    | Name: Product View Location 
ID evar38                    | Name: Removed-from-Wishlist Location 
ID evar39                    | Name: Login Type 
ID evar4                     | Name: eVar 4 
ID evar41                    | Name: site navigation 
ID evar42                    | Name: Site Sub navigation 
ID evar44                    | Name: Server Error API 
ID evar45                    | Name: Deeplink 
ID evar46                    | Name: Push Notification 
ID evar47                    | Name: Extra Cart details 
ID evar48                    | Name: brand Filters 
ID evar49                    | Name: Category Filters 
ID evar5                     | Name: eVar 5 
ID evar50                    | Name: Price Filters 
ID evar51                    | Name: Other Filters 
ID evar52                    | Name: Banners 
ID evar6                     | Name: Internal Search Term (Conversion) 
ID evar8                     | Name: Subsection Level 1 
ID evar9                     | Name: Subsection Level 2 
ID evar97                    | Name: Custom Link Name 
ID evar99                    | Name: Interaction Page Name 
ID experience                | Name: Experience 
ID firsttouchchannel         | Name: First Touch Marketing Channel 
ID firsttouchchanneldetail   | Name: First Touch Marketing Channel Detail 
ID geocity                   | Name: GeoSegmentation City 
ID geocountry                | Name: GeoSegmentation Country 
ID geodma                    | Name: GeoSegmentation U.S. DMA 
ID georegion                 | Name: GeoSegmentation Region 
ID geostate                  | Name: GeoSegmentation State 
ID javaenabled               | Name: Java Enabled 
ID javascriptenabled         | Name: JavaScript Enabled 
ID javascriptversion         | Name: JavaScript Version 
ID language                  | Name: Language 
ID lasttouchchannel          | Name: Last Touch Marketing Channel 
ID lasttouchchanneldetail    | Name: Last Touch Marketing Channel Detail 
ID linkcustom                | Name: Custom Link 
ID linkdownload              | Name: File Download 
ID linkexit                  | Name: Exit Link 
ID listvar2                  | Name: Voucher Code 
ID mobileaction              | Name: Action Name 
ID mobileappid               | Name: App Id 
ID mobileaudiosupport        | Name: Audio Support 
ID mobilecampaigncontent     | Name: Acquisition Content 
ID mobilecampaignmedium      | Name: Acquisition Medium 
ID mobilecampaignname        | Name: Acquisition Name 
ID mobilecampaignsource      | Name: Acquisition Source 
ID mobilecampaignterm        | Name: Acquisition Term 
ID mobilecarrier             | Name: Mobile Carrier 
ID mobilecolordepth          | Name: Color Depth 
ID mobilecookiesupport       | Name: Cookie Support 
ID mobiledayofweek           | Name: Day of Week 
ID mobiledayssincefirstuse   | Name: Days Since First Use 
ID mobiledayssincelastuse    | Name: Days Since Last Use 
ID mobiledeeplinkid          | Name: Launch Name 
ID mobiledevice              | Name: Device Name 
ID mobiledeviceid            | Name: Mobile Device ID 
ID mobiledevicename          | Name: Devices 
ID mobiledevicenumbertransmit | Name: Device Number Transmit (ON/OFF) 
ID mobiledevicetype          | Name: Device Type 
ID mobiledrm                 | Name: DRM 
ID mobilehourofday           | Name: Hour of Day 
ID mobileimagesupport        | Name: Image Support 
ID mobileinformationservices | Name: Information Services 
ID mobileinstalldate         | Name: First Launch Date 
ID mobilejavavm              | Name: Java Version 
ID mobilelaunchnumber        | Name: Launch Number 
ID mobileltv                 | Name: Lifetime Value (evar) 
ID mobilemaildecoration      | Name: Decoration Mail Support 
ID mobilemanufacturer        | Name: Manufacturers 
ID mobilemaxbookmarkurllength | Name: Bookmark URL Length 
ID mobilemaxbrowserurllength | Name: Browser URL Length 
ID mobilemaxmailurllength    | Name: Mail URL Length 
ID mobilemessagepushoptin    | Name: Push Opt-in 
ID mobilemessagepushpayloadid | Name: Payload ID 
ID mobilenetprotocols        | Name: Net Protocols 
ID mobileos                  | Name: Operating System (deprecated) 
ID mobileosversion           | Name: Operating System Version 
ID mobilepushtotalk          | Name: PTT 
ID mobilerelaunchcampaigncontent | Name: Launch Content 
ID mobilerelaunchcampaignmedium | Name: Launch Medium 
ID mobilerelaunchcampaignsource | Name: Launch Source 
ID mobilerelaunchcampaignterm | Name: Launch Term 
ID mobilerelaunchcampaigntrackingcode | Name: Launch Tracking Code 
ID mobileresolution          | Name: Resolution 
ID mobilescreenheight        | Name: Screen Height 
ID mobilescreensize          | Name: Screen Sizes 
ID mobilescreenwidth         | Name: Screen Width 
ID mobilevideosupport        | Name: Video Support 
ID monitorcolordepth         | Name: Monitor Color Depth 
ID monitorresolution         | Name: Monitor Resolution 
ID operatingsystem           | Name: Operating System 
ID operatingsystemtype       | Name: Operating System Type 
ID page                      | Name: Page 
ID pagedepth                 | Name: Page Depth 
ID pagesnotfound             | Name: Pages Not Found 
ID pathlength                | Name: Path Length 
ID product                   | Name: Product 
ID prop1                     | Name: Screen Name 
ID prop10                    | Name: Subsection Level 3 
ID prop11                    | Name: AlertViewPopup Message 
ID prop6                     | Name: Internal Search Term (Traffic) 
ID prop8                     | Name: Subsection Level 1 
ID prop9                     | Name: Subsection Level 2 
ID referrer                  | Name: Referrer 
ID referrertype              | Name: Referrer Type 
ID referringdomain           | Name: Referring Domain 
ID referringdomainoriginal   | Name: Original Referring Domain 
ID reportsuite               | Name: Report Suite 
ID returnfrequency           | Name: Return Frequency 
ID searchengine              | Name: Search Engine 
ID searchenginekeyword       | Name: Search Keyword 
ID searchenginenatural       | Name: Natural Search Engine 
ID searchenginenaturalkeyword | Name: Natural Search Keyword 
ID searchenginenaturalpagerank | Name: Natural Search Page Rank 
ID searchenginepaid          | Name: Paid Search Engine 
ID searchenginepaidkeyword   | Name: Paid Search Keyword 
ID server                    | Name: Server 
ID sitesection               | Name: Site Section 
ID state                     | Name: State 
ID surveybase                | Name: Survey 
ID timeprior                 | Name: Time Prior to Event 
ID timevisit                 | Name: Time Spent Per Visit 
ID timezone                  | Name: Time Zone 
ID tntbase                   | Name: Test&Target 
ID topleveldomain            | Name: Top Level Domain 
ID trackingcode              | Name: Tracking Code 
ID videoconcurrentviewers    | Name: Video Concurrent Viewers 
ID videos                    | Name: Videos 
ID visitnumber               | Name: Visit Number 
ID zip                       | Name: ZIP/Postal Code 
